########################################
#                                      #
#                                      #
#    ###########     ##########        #
#    #               #        #        #
#                             #        #
#              #              #        #
#              #              #        #
#    ###########     ##########        #
#                             #        #
#                                      #
#                                      #
#    ###########      ##########       #
#              #   U  #                #
#              #      #                #
#    #         #      #                #
#    #         #    ###                #
#    #         #      #############    #
#    #         #                       #
#    #         ###        ######       #
#    #         #          #    #       #
#    #         #      #####    ###     #
#    #         #    ###                #
#    #         #      #                #
#    #     #####      #     ############
#                                      #
#                                      #
# @                                    #
########################################
